##########
#        #
#\#. ## ##
#.#.  #. #
#.  # =#.#
# # . .=%#
# # # #=##
# . =## ##
# .##=   #
##########
