#######################
#=# #             # \ #
#=# # # ####### # # ###
#=#   # ...#    #     #
#=########.# ######## #
###     .....         #
#######################
