#######################
#..........#..........#
#.###.####.#.####.###.#
#o###.####.#.####.###o#
#.....................#
#.###.#.#######.#.###.#
#.....#....#....#.....#
#####.#### # ####.#####
#   #.#    =    #.#   #
#####.# ### ### #.#####
#    .  # === #  .    #
#####.# ####### #.#####
#   #.#    %    #.#   #
#####.# ####### #.#####
#..........#..........#
#.###.####.#.####.###.#
#   #  .... ......#..o#
### # # #######.#.#.###
#    \# ...#....#.....#
# ########.#.########.#
#      ...............#
#######################
