#############
#\.=........#
# ###########
# ...=......#
# ###########
# .....=....#
# ###########
# .......=..#
# ###########
# ooooooooo%#
#############
