##################
#\.=.............#
# ################
# ...=...........#
# ################
# ...............#
# ################
# ...............#
# ################
# ..........=....#
# ################
# ............=..#
# ################
# oooooooooooooo%#
##################
